1111111111111
1P000000000E1
1111101111111
1CC0CC0111111
11110C1111111
1CC0000000CC1
1111111111111
