1111111111111111
1P000000000000E1
1111111111111001
1C0000000000C001
1001111111111101
1C00000000000001
1111111111111111
