1111111111111111111111
1P00000000000000000001
100000000C000000000001
10000000CCC00000000001
1000000CCCCC0000000001
100000CCCCCCC000000001
10000CCCCCCCCC00000001
10000000000000000000E1
1111111111111111111111
